w w w w w w w w w w w w w w w w w w w w w w w w w w w w w w w w w w w w w w w w
w g g g g g g g g g g g g g g g g g g g g g g g g g g g g g g g g g g g g g g w
w g g g g g g g g g g g g g g g g g g g g g g g g g g g g g g g g g g g g g g w
w g g g g g g g g g g g g g g g g g g g g g g g g g g g g g g w w w w w g g g w
w g g g g g g g g g g g g g g g g g g g g g g g g g g g g g g w p p p w g g g w
w g g g g g g g g g g g g g g g g g g g g g g g g g g g g g g w # # # w g g g w
w g g g g g g g g g g g g g g g g g g g g g g g g g g g g g g w w b w w g g g w
w g g g w w w w w w w w w w w w w w w w w w w w w w w w w w w w g g g w g g g w
w g g g w P # # # # # # # # # # # # # # # # # # # # # # # # s s g g g w g g g w
w g g g w p # # # # # # # # # # # # # # # # # # # # # # # # s s g g g w g g g w
w g g g w p # w w w w w w w w w w w w w w w w w w w w w w w w w w w w w g g g w
w g g g w p # w g g g g g g g g g g g g g g g g g g g g g g g g g g g g g g g w
w g g g w # # w g g g g g g g g g g g g g g g g g g g g g g g g g g g g g g g w
w g g g w # # w g g g g g g g g g g g g g g g g g g g g g g g g g g g g g g g w
w g g g w # # w g g g g g g g g g g g g g g g g g g g g g g g g g g g g g g g w
w g g g w @ # w g g g g g g g g g g g g g g g g g g g g g g g g g g g g g g g w
w g g g w w w w g g g g g g g g g g g g g g g g g g g g g g g g g g g g g g g w
w g g g g g g g g g g g g g g g g g g g g g g g g g g g g g g g g g g g g g g w
w g g g g g g g g g g g g g g g g g g g g g g g g g g g g g g g g g g g g g g w
w g g g g g g g g g g g g g g g g g g g g g g g g g g g g g g g g g g g g g g w
w g g g g g g g g g g g g g g g g g g g g g g g g g g g g g g g g g g g g g g w
w w w w w w w w w w w w w w w w w w w w w w w w w w w w w w w w w w w w w w w w