g g g g g g g b g g g g g g g g g g g g g g g g g g g g g g g g g g g g g g g g
g @ # # # # h # # # # # # # # # # # # ! s s s s s g g g g g g g g g g g g g g g
g g g g g 0 C # g g g g g g g w w w w g g g g g g g g g g g g g g g g g g g g g
g g g g g g g # g g g g g g g w ? g w g g g g g g g g g g g g g g g g g g g g g
g g g g g g g # g g g g g g g w g g w g g g g g g g g g g g g g g g g g g g g g
g g g g g g g # g g g g g g g w w w w g g g g g g g g g g g g g g g g g g g g g
g g g g g g g # g g g g g g g g g g g g g g g g g g g g g g g g g g g g g g g g
g g g g g g g # g g g g g g g g g g g g g g g g g g g g g g g g g g g g g g g g
g g g g g g g # g g g g g g g g g g g g g g g g g g g g g g g g g g g g g g g g
g g g g g g g # g g g g g g g g g g g g g g g g g g g g g g g g g g g g g g g g
g g g g g g g # g g g g g g g g g g g # g # # # # # # # # # # # # # g g g g g g
g g g g g g g # g g g g g g g g g g g g g g g g g g g g g g g g g g g g g g g g
g g g g g g ? # g g g g g g g g g g g g g g g g g g g g g g g g g g g g g g g g
g g g g g g g g g g g g g g g g g g g g g g g g g g g g g g g g g g g g g g g g
g g g g g g g g g g g g g g g g g g g g g g g g g g g g g g g g g g g g g g g g
g g g g g g g g g g g g g g g g g g g g g g g g g g g g g g g g g g g g g g g g
g g g g g g g g g g g g g g g g g g g g g g g g g g g g g g g g g g g g g g g g
g g g g g g g g g g g g g g g g g g g g g g g g g g g g g g g g g g g g g g g g
g g # # # # # # # # # # # # # # # # # # g g g g g g g g g g g g g g g g g g g g
g g g g g g g g g g g g g g g g g g g g g g g g g g g g g g g g g g g g g g g g
g g g g g g g g g g g g g g g g g g g g g g g g g g g g g g g g g g g g g g g g
g g g g g g g g g g g g g g g g g g g g g g g g g g g g g g g g g g g g g g g g