w w w w w w w w w w w w w w w w w w w w w w w w w w w w w w w w w w w w w w w w
w g g g g g g g g g g g g g g g g g g g g g g g g g g g g g g g g g g g g g g w
w g ! # # # # # # # # # # # # # # # # b # # # # # # # # # # # # # # # # # # g w
w g s s s s s s s s s s s s s s s s s # g g g g g g g g g g g g g g g g g g g w
w g g g g g g g g g g g g g g g g g g # g g g g g g g g g g g g g g g g g g g w
w g g g g g g g g g g g g g g g g g g # g g g g g g g g g g g g g g g g g g g w
w g g g g g g g g g g g g g g g g g g # g g g g g g g g g g g g g g g g g g g w
w g g g g g g g g g g g g g g g g g g # g g g g g g g g g g g g g g g g g g g w
w g g g g g g g g g g g g g g g g g g # g g g g g g g g g g g g g g g g g g g w
w g g g g g g g g g g g g g g g g g g # g g g g g g g g g g g g g g g g g g g w
w g g g g g g g g g g g g g g g g g g @ g g g g g g g g g g g g g g g g g g g w
w g g g g g g g g g g g g g g g g g g # g g g g g g g g g g g g g g g g g g g w
w g g g g g g g g g g g g g g g g g g # g g g g g g g g g g g g g g g g g g g w
w g g g g g g g g g g g g g g g g g g # g g g g g g g g g g g g g g g g g g g w
w g g g g g g g g g g g g g g g g g g # g g g g g g g g g g g g g g g g g g g w
w g g g g g g g g g g g g g g g g g g # g g g g g g g g g g g g g g g g g g g w
w g g g g g g g g g g g g g g g g g g # g g g g g g g g g g g g g g g g g g g w
w g g g g g g g g g g g g g g g g g g # g g g g g g g g g g g g g g g g g g g w
w g g g g g g g g g g g g g g g g g g # s s s s s s s s s s s s s s s s s s g w
w g # # # # # # # # # # # # # # # # # # # # # # # # # # # # # # # # # # # ! g w
w g g g g g g g g g g g g g g g g g g g g g g g g g g g g g g g g g g g g g g w
w w w w w w w w w w w w w w w w w w w w w w w w w w w w w w w w w w w w w w w w