w w w w w w w w w w w w w w w w w w w w w w w w w w w w w w w w w w w w w w w w
w g g g g g g g g g g g g g g g g g g g g g g g g g g g g g g g g g g g g g g w
w g g g g g g g g g g g g g g g g g g g g g g g g g g g g g g g g g g g g g g w
w g g g g g g g g w w w w w g g g g g g g g g g g g g g g g g g g g g g g g g w
w g g g g g g g g w h h h w g g g g g g g g g g g g g g g g g g g g g g g g g w
w g g g g g g g g w # # # w g g g g g g g g g g g g g g g g g g g g g g g g g w
w g g g g g g g g w w g w w g g g g g g g g g g g g g g g g g g g g g g g g g w
w g g g g g g g g g w g w g g g g g g g g g g g g g g g g g g g g g g g g g g w
w g g g w w w w w w w g w w g g g g g g g g g g g g g g g g g g g g g g g g g w
w g g g w # # # # # # # # # # # # # # # # # # # # P g g g g g g g g g g g g g w
w g g g w # # w w w w w w w w w w # w g g g g g g g g g g g g g g g g g g g g w
w g g g w # # w g g g g g g g g w # w g g g g g g g g g g g g g g g g g g g g w
w g g g w # # w g g g g g g g g w # w g g g g g g g g g g g g g g g g g g g g w
w g g g w # # w g g g g g g w w w # w w w g g g g g g g g g g g g g g g g g g w
w g g g w # # w g g g g g g w ! # # # ! w g g g g g g g # # ! # # g g g g g g w
w g g g w # # w g g g g g g w w w # w w w g g g g g g g # g c g # g g g g g g w
w g g g w # # w g g g g g g g g w # w g g g g g g g g g # c C c # g g g g g g w
w g g g w @ # w g g g g g g g g w # w g g g g g g g g g # g c g # g g g g g g w
w g g g w w w w g g g g g g g w w # w w g g g g g g g g # # ! # # g g g g g g w
w g g g g g g g g g g g g g g w # # # w g g g g g g g g g g g g g g g g g g g w
w g g g g g g g g g g g g g g w p p p w g g g g g g g g g g g g g g g g g g g w
w w w w w w w w w w w w w w w w w w w w w w w w w w w w w w w w w w w w w w w w