w w w w w w w w w w w w w w w w w w w w w w w w w w w w w w w w w w w w w w w w
w g g g g g g g g g g g g g g g g g g g g g g g g g g g g g g g g g g g g g g w
w g g g g g g g g g g g g g g g g g g g g g g g g g P g g g g g g g g g g g g w
w g g g g g g g g g g g g g g g g g g g g g g g g g # g g g g g g g g g g g g w
w g g g g g g g g g g g g g g g g g g g g g g g g g # g g g g g g g g g g g g w
w g g g g g g g g g g g g g g g g g g g g g g g g g # g g g g g g g g g g g g w
w g g g g g g g g g g g g g g g g g g g g g g g g g # g g g g g g g g g g g g w
w g g g g g g g g g g g g g g g g g g g g g g # # # # # g g g g g g g g g g g w
w g g g g g g g g g g b g g g g g b g g g g g b # # # # g g g g g g g g g g g w
w g g g g # # # # # # g # # # # # g # # # # # g # # # # g g g g g g g g g g g w
w g g g g # # g g g w # w g g g w # w g g g w # w g g g g g g g g g g g g g g w
w g g g g # # g g g w # w g g g w # w g g g w # w g g g g g g g g g g g g g g w
w g g g g # # g g g w # w g g g w # w g g g w # w g g g g g g g g g g g g g g w
w g g g g # # g g g w # w g g g w # w g g g w # w g g g g g g g g g g g g g g w
w g g g g # # g g g w ? w g g g w ? w g g g w ? w g g g g g g g g g g g g g g w
w g g g g # # g g g w # w g g g w # w g g g w # w g g g g g g g g g g g g g g w
w g g g g # # g g g w # w g g g w # w g g g w # w g g g g g g g g g g g g g g w
w g g g g @ # g g g w # w g g g w # w g g g w # w g g g g g g g g g g g g g g w
w g g g g g g g g w # # # w g w # # # w g w # # # w g g g g g g g g g g g g g w
w g g g g g g g g w # # # w g w # # # w g w # # # w g g g g g g g g g g g g g w
w g g g g g g g g w g # g w g w p # g w g w p # p w g g g g g g g g g g g g g w
w w w w w w w w w w w w w w w w w w w w w w w w w w w w w w w w w w w w w w w w