w w w w w w w w w w w w w w w w w w w w w w w w w w w w w w w w w b w w w w w w
w g g g g g g g g g g g g g g g g g g g g g g g g g g g g g g g g b g g g g g w
w g g g g g ! # # # # # g g g g g g g g g g g g g g P g g g g g g b g g g g g w
w g g g g g # g j c g # g g g g g g g g g g g g g g # g g g g g g g g g g g g w
w g g g g g # g c C g # g g g g g g g g g g g g g g # g g g g g w g w g g g g w
w g g g g g # # # # # ! g g g g g g g g g g g g g g # g g g g g g g g g g g g w
w g g g g g g g g g g g g g g g g g g g g g g g g g # g g g g g w w w g g g g w
w g g g g g g g g g g g g g g g g g g g g g g # # # # # g g g g g g g g g g g w
w g g g g g g g g g g b g g g g g b g g g g g b # # # # g g g g g g g g g g g w
w g g g g # # # # # # g # # # # # g # # # # # g # # # # g g g g g g g g g g g w
w g g g g # # g g g w # w g g g w # w g g g w # w g g g g g g g g g g g g g g w
w g g g g # # g g g w # w g g g w # w g g g w # w g g g g g g g g g g g g g g w
w g g g g # # g g g w # w g g g w # w g g g w # w g g g g g g g g g g g g g g w
w g g g g # # g g g w # w g g g w # w g g g w # w g g g g g g g g g g g g g g w
w g g g g # # g g g w ? w g g g w ? w g g g w ? w g g g g g g g g g g g g g g w
w g g g g # # g g g w # w g g g w # w g g g w # w g g g g g g g g g g g g g g w
w g g g g # # g g g w # w g g g w # w g g g w # w g g g g g g g g g g g g g g w
w g g g g @ # g g g w # w g g g w # w g g g w # w g g g g g g g g g g g g g g w
w g g g g g g g g w # # # w g w # # # w g w # # # w g g g g g g g g g g g g g w
w g g g g g g g g w # # # w g w # # # w g w # # # w g g g g g g g g g g g g g w
w g g g g g g g g w C # C w g w p # j w g w p # p w g g g g g g g g g g g g g w
w w w w w w w w w w w w w w w w w w w w w w w w w w w w w w w w w w w w w w w w