w w w w w w w w w w w w w w w w w w w w w w w w w w w w w w w w w w w w w w w w
w g g g g g g g g g g g g g g g g g g g g g g g g g g g g g b g g h h h g g g w
w g g g g g g g g g g g g g g g g g g g g g g g g g g g g g b w w w w b b b g w
w g g g g g g g g w w w w w g g g g g g g g g g g g g g g g g # # # # b b b g w
w g g g g g g g g w h h h w g g g g g g g g g g g g g g g g w w p p p b b b g w
w g g g g g g g g w # ! # w g g g g g g g g g g g g g g g g g w w w w b b b g w
w g g g g g g g g w w g w w g g g g g g g g g g g g g g g g g g g g w b b b g w
w g g g g g g g g g w g w g g g g g g g g g g # # # # # g g g g g g w b b b g w
w g g g g g g g g g g g g g g g g g g g g g g ! # # # # g g g g g g w b b b g w
w g g g g # # # # # # # # # # # # ! # # # # # # # P # # g g g g g g w b b b g w
w g g g g # # g g g g g g g g g g g g g g g g # # # # ! g g g g g g w b b b g w
w g g g g # # g g g g g g g g g g g g g g g g # # # # # g g g g g g w b b b ? w
w g g g g # # g g g g g g g g g g g g g g g g g g g g g g g g g g g w b b b g w
w g g g g # # g g g g g g g g g g g g g g g g g g g g g g g g g g g w b b b g w
w g g g g # # g g g g g g g g g g g g g g g g g g g g g g g g g g g w b b b g w
w g g g g # # g g g g g g g g g g g g g g g g g g g g g g g g g g b w b b b g w
w g g g g # # g g g g g g g g g # # # # # # # g g g g g g g g g b b w b b b g w
w g g g g @ # g g g g g g g g g # g g g g g # g g g g g g g g b b b w b b b g w
w g g g g g g g g g g g g g g g # g g g g g # g g g g g g g b b b b w b b b g w
w g g g g g g g g g g g g g g g ! g h j h g ! g g g g g g b b b b b w g w w g w
w g g g g g g g g g g g g g g g # g c C c g # g g g g g g g g g g g w g g g g w
w w w w w w w w w w w w w w w w w w w w w w w w w w w w w w w w w w w w w w w w